########
#@     #
# $*.. #
#  $.  #
#  $.  #
#  $.$ #
# **** #
#      #
########
Title: L -> I
Collection: Sokoban Online
Author: Francois Marques
AuthorMail: sokoban@online.fr
AuthorPage: http://sokoban.online.fr/
Date: 2001/08
